
NO textures/a.txt

EA textures/b.txt

SO textures/c.txt

C 53,  41,34

F   45, 33, 27

WE textures/d.txt

111111111111111111
110000000000000011
110000000000000011
110000000000000011
1100E0000000000011
11000000000000000011
110000000000000011
110000000000000011
111111111111111111
