
NO a.txt

EA  b.txt

SO c.txt

C 53,  41,34

F   45, 33, 27

WE d.txt

111111111111111111
110000000000000011
110000000000000011
110000000000000011
1100N0000000000011
11000000000000000011
110000000000000011
110000000000000011
111111111 111111111
111111111111111111