
NO textures/soul_sand.xpm  

EA     textures/soul_sand.xpm

SO textures/soul_soil_01.xpm

C 53,  41,34

F   45, 33, 27

WE textures/soul_soil.xpm

111111111111111111
110000000000000011
110000000000000011
110000000000000011
1100N0000000000011
1                1
1                1
11000000000000100011
11000000000111 111
11000010001    111
111111 1111111 111


