NO textures/soul_sand.xpm  


EA     textures/soul_sand.xpm

SO textures/soul_soil_01.xpm

C 53,41,34

F   45,33,27



    111111111111111
    111111000111111
111110000011111
1111000N0001111
WE textures/soul_soil.xpm
111000000000111
110000000000011

100001111100001
110000111000011
111000010000   111
111100000001111
111110000011111
111111000111111
111111111111111

000