NO assets/textures/brick1.png
SO assets/textures/brick2.png
WE assets/textures/brick3.png
EA assets/textures/brick4.png
DD assets/textures/door/door3.png

F 20,18,16
C 04,02,73

111111111111111111111111111111111
1110D0100000000000110D00000001001
111010101011000001110000000001001
111D1000100100000000000000000 001
11101111101100000111000 000001001
1000000000110000011101111111111 1
1111011111111101110000000000111 1
1111011111111101110101001000111 1
1100000011010101110000001000111 1
1000000 000000001100000011 1111 1
10000000000000001101010010000   1
1 00000 110101011111011110N011111
111   11111101011101111  00011111
111111111111111111111111111111111