NO assets/textures/brick1.png
SO assets/textures/brick2.png
WE assets/textures/brick3.png
EA assets/textures/brick4.png
DO assets/textures/door/door3.png

F 20,18,16
C 00,00,100

        1111111111111111111111111
        1000000000110000000000001
        1011000001110000000000001
        1001000000000000000000001
111111111011000001110000000000001
100000000011000001110111111111111
1111011111111101110e00000e0e1
11110111111111011101010010001
11000000110101011100000010001
100000000000000011000000dDDD1
100000000000000011010100d0W01
110000011101010111110111d000111
11110111 1110101 10111101ahx1
11111111 1111111 111111111111