NO assets/textures/brick5.png
SO assets/textures/brick6.png
WE assets/textures/brick7.png
EA assets/textures/brick8.png
DD assets/textures/door/door3.png

F 20,18,16
C 04,02,73


11111111111111111111111111111111111111111111111
11111111111000000000000000D11111111DDDDDDD11111
11111101111011111110111111111111111D00000D11111
111110001110111111100D0D0D00D001111D01010D11111
11111101111011111111011111101101111D00000D11111
11111000111000000000011111101101111D01010D11111
110101D10101D11110110000D0001100000000000D11111
10000000000001111011D11111101101111111111111111
10101010101101111011000111101011111111111111111
11111D111111011110110N000D000000000011111D11111
11111011111100011011000111101011011011111011111
111110111111011110111D11111010110110D000000D111
11111011111101111000D0D011101011000011111011111
111110000001011111111D1111101011111111111D11111
11111111D11101111111101111101111111111111111111
111111D0000000000000001110000011111111111111111
11111111111111111111111111111111111111111111111