NO assets/textures/laurin/lwall1.png
SO assets/textures/laurin/lwall2.png
WE assets/textures/laurin/lwall3.png
EA assets/textures/laurin/lwall4.png
DO assets/textures/door/lock.png

F 203,166,247
C 4,165,229

        1111111111111111111111111
        1000000000110000000000001
        1011000001110000000000001
        1001000000000000000000001
111111111011000001110000S00000001
100000000011000001110111D11111111
11110111111111011100000000001
11110111111111011101010010001
11000000110101011100000010001
10000000000000001100000010001
10000000000000001101010010001
1100000111010101111101111000111
11110111 1110101 101111010001
11111111 1111111 111111111111
