NO assets/textures/wolf_cobble_wall.png
SO assets/textures/wolf_cobble_wall1.png
WE assets/textures/wolf_moss_wall0.png
EA assets/textures/wolf_moss_wall1.png
DD assets/textures/door/wolf_door.png

F 255,0,0
C 04,02,73

111111111111111111111111111111111
1110D0100000000000110000000001001
111010101011000001110000000001001
11101000100100000000000000000D001
111D11111011000001110000000001001
100000000011000001110111111111101
111101111111110111000000000011101
111101111111110111010100100011101
110000001101010111000000100011101
10000000000000001100000011D111101
100000000000000011010100100000001
10000000110101011111011110N011111
111000111111010111011110000000111
111111111111111111111111111111111
