NO assets/textures/the_scream.png
SO assets/textures/the_scream.png
WE assets/textures/the_starry_night.png
EA assets/textures/the_tower_of_babel.png

C 0,0,60
F 60,179,110


        11111111111111111111111111
        100000000011100000000000001
        10110000011 110000000000001
        10010000000100000000000011
111111111011000001110000000000001
100000000011000001110111110111111
11110111111111011100000010001
11110111111111000001010010001
11W00000110101011100000010001
10000000000000001100000010001
10000000000000001101010010001
1100000111010101111101111000111
11110111 10110101 11111010001
11111111 1111111 111111111111