NO assets/textures/flowers.png

EA assets/textures/wall.png

SO assets/textures/plants.png



C  100,  50,80

F  100  ,0,5


WE assets/textures/bricks.png

111111111111111111
1100001000000000011
110000110000100011
110000000000000011
110000000000100011
11000000000000000011
110000000100N00011
110001000000000011
111111111111111111
