
NO assets/textures/a.txt

EA assets/textures/b.txt

SO assets/textures/c.txt

C 53,  41,34

F   45, 33, 27

WE assets/textures/d.txt

111111111111111111
1100001000000000011
110000110000100011
110000000000000011
110000E00000100011
11000000000000000011
110000000100000011
110001000000000011
111111111111111111
