
NO assets/textures/flowers.png

EA assets/textures/wall.png

SO assets/textures/plants.png

C 50,  34

F   255, 33, 27     

WE assets/textures/bricks.png

111111111111111111
1100001000000000011
110000110000100011
110000000000000011
110000S00000100011
11000000000000000011
110000000100000011
110001000000000011
111111111111111111
